A	AH
A(2)	EY
AND	AH N D
AND(2)	AE N D
BEAVER	B IY V ER
BLOW	B L OW
CAKE	K EY K
CATCH	K AE CH
COLD	K OW L D
DOWN	D AW N
EAGER	IY G ER
FAIR	F EH R
FEET	F IY T
FUSE	F Y UW Z
GET	G EH T
GET(2)	G IH T
LEGS	L EH G Z
LOUD	L AW D
MELLOW	M EH L OW
OF	AH V
OUT	AW T
PIECE	P IY S
PULLING	P UH L IH NG
SOME	S AH M
SQUARE	S K W EH R
THE	DH AH
THE(2)	DH IY
THINKING	TH IH NG K IH NG
TO	T UW
TO(2)	T IH
TO(3)	T AH
WIRE	W AY ER
WIRE(2)	W AY R
YOUR	Y AO R
YOUR(2)	Y UH R
ZS	Z IY S
